########
#@*#####
##*#####
##*#####
##**####
###**###
####**&#
########
