########
#******#
#*####*#
###****#
###*##*#
##**##*#
##*###&#
########
