########
#**#####
##**####
###**###
####**##
#####**#
######&#
########
