################################################
#!##!!!!#**************##*####*#*####********###
#!##!##!#*##########*##*#*###****#**#*#*####*###
#!!!!#!!#!!!!!!!!#*#****#***#*##*##*#*#*#**#*###
#*####!##!#*####!#**###*###***#**#****#***##**##
#****#!!!!#*####!##*#****##*###*##*##*#######*##
#*##*####*###**#!!#*#*##****##*****##*#***###*##
#*#**#**#***#*###!#*##########*######***#*#****#
#*#*##*######***#!!*##**##**#########*#*#*#*####
#*#****##***###*##!##**##**#*#*#***##*#*#*#***##
#*#######*#*##**#!!#**##**##*#*#*#*##*#*###*#*##
#*******#*#**##*#!##*##**###*****#****####**#*##
#*#*###***##*##*#!******##*#*#*#*#*####**#*##*##
#*#*###*####****#!#######**#*###*#*#*******##**#
#*#***#**#***####!##!!!#**##*#*#####*#*#######*#
#*###*##*#*#*#***!!!!#!**#***#*#!!!#*#****###**#
#*#***#**#*###*##*#*##!#####*#*#!#!**######*##*#
#*#*###*#**#***#**#**#!!##!!!!!!!#!###!!!!#!!!##
#*##****#*##*#*#####*##!!!!#######!!!!!##!!!#!!#
################################################
