########
#@*#####
##*#####
##**####
###**###
####**##
#####*&#
########
