########################################
#**############*########################
##**##*#*######*########################
###******######*########################
#######**######*########################
#######*#######*########################
#######*#######*########################
####*********##*########################
####*##*#*#####*################**######
####*####*####*******########*****######
####***##**###*#####**#######*##**######
#####**###*****######****####*##**######
#####*##################**###*##**######
#########################***#*###*****##
###########################****######*##
##############################***####*##
###############################***###*##
#################################***#*##
##################################****&#
########################################
