########
#**#####
#***####
###*####
###**###
####**##
#####*&#
########
