################
#!!#############
##!!*###########
###!!###########
####!!##########
#####!!#########
######!!!!!!####
###########!!!!#
##############!#
################
