################
#!*#############
#!**############
#!!!!###########
####!!!#########
######!!!#######
########!!!!*###
###########!!!!#
##############!#
################
