################
#!##############
#!!#############
##!###*#########
##!!!!!!!*######
########!!######
#########!######
#########!!!!!!#
##############!#
################
