################
#!!#############
##!#############
##!!!!!!!!######
#########!######
#########!######
#########!######
#########!!!!!!#
##############!#
################
