################
#!!#############
##!!!###########
####!!##########
#####!!!########
#######!!!######
#########!!!!!!#
##############!#
##############!#
################
