################################
#!!#############################
##!#############################
##!#############################
##!#############################
##!#############################
##!#############################
##!#############################
##!#############################
##!#############################
##!#############################
##!#############################
##!#############################
##!#############################
##!#############################
##!!############################
###!!###########################
####!!!!!!!!!!!!!!!!!!!!!!!!!!!#
##############################!#
################################
