################
#!!#############
##!!############
###!!###########
####!!##########
#####!!!########
#######!!!!!####
###########!!!!#
##############!#
################
