################
#!!!!!!!########
#######!########
#######!########
###!!!!!########
###!############
###!############
###!!!!!!!!!!###
############!!!#
################
