################
#!!!############
###!*###########
###!*###########
###!!##*########
##*#!!!!########
##*#*##!#*######
#######!!!!!!###
#######*##*#!!!#
################
