################
#!##############
#!##############
#!##############
#!##############
#!##############
#!##############
#!!!*###########
###!!!!!!!!!!!!#
################
