################
#!!!!!##########
#####!!!########
#######!########
#######!########
###!!!!!########
###!############
###!!!!#########
######!!!!!!!!!#
################
