################
#!##############
#!!#############
##!!############
###!############
###!############
###!!!!!###!!!##
#######!!!!!#!##
#############!!#
################
