################
#!##############
#!!!############
###!!!!##*######
######!!########
#######!!!!#####
##########!!####
###########!!!!#
##############!#
################
