################
#!!#############
##!!############
###!!###########
####!!##########
#####!!!!#######
########!!######
#########!!!!###
############!!!#
################
